........
........
........
...+-...
...-+...
........
........
........
