........
........
........
...-+...
...+-...
........
........
........
