........
........
..-+....
..---...
...+--..
...+....
........
........
